 =StartUpServlet
login=LoginServlet
register=register.jsp
registerAcc=RegisterServlet
signin=login.jsp
admin=adminPage.jsp
manage=ManageSubjectServlet
manageQuestion=manage.jsp
createSubject=CreateNewSubjectServlet
createQuestion=createQuestion.jsp
create=CreateQuestionServlet
update=UpdateQuestionServlet
get=GetQuestionToUpdateServlet
delete=DeleteQuestionServlet
updatePage=update.jsp
searchPage=search.jsp
search=SearchQuestionServlet
startup=StartUpServlet
subject=SubjectServlet
logout=LogoutServlet
takeQuiz=TakeQuizServlet
quiz=quiz.jsp
checkAnswer=CheckAnswerServlet
result=result.jsp
history=HistoryServlet
historyPage=history.jsp
searchHistory=SearchHistoryServlet
searchHistoryPage=searchHistory.jsp
student=subject.jsp
getSubject=GetSubjectToCreateQuestionServlet
error=error.jsp